5 6 1
WWWWWW
WNNWOW
WPBNNW
WWOWGW
WWWWWW
