9 9 3
WWWWWNNNN
WPNNWNNNN
WOBBWNWWW
WNBNWNWGW
WWWNWWWGW
NWWNNNNGW
NWNNNONNW
NWNNNWWWW
NWWWWWNNN