7 10 5
NNNWWWWWWN
NWWWNNNNWN
WWGNBWWNWW
WGGBNBNNPW
WGGNBOBNWW
WWWWWWNOWN
NNNNNWWWWN
